111111111111111111111111111111111111111111111111
100000000000000000000001000P00010000000000000001
1000000P000000000000000110000001P000000000000001
10000000000000000P000001101C1001000000000P000001
11111111111111111C111111111111111111111111111111
100000000000000000000001100P0P110000000000000001
100000000000000000000001100000010000000000000001
10000000000000000P000001111111110000000P00000111
100000000000N00000000001100000000000000000000001
100000000000000000000001100000000000000000000001
10000000000000000P00000110000000000000000P000001
100000000000000001000001100000000000000001000001
1000000P000000000P00000110000000000000000P000001
100000000000000000000001100P00000000000000000001
100000000000100000000001100000000000100000000001
111111111111111111111111111111111111111111111111
