111111111111111111111111
100000000000000000000001
100000000000000000000001
100000000000000001000001
111111111111111111111111
100000000000000000000001
100000000000000000000001
100000000000000001000001
11000000000N000000000011
100000000000000000000001
100000000000000001000001
100000000000000001000001
10000C000000000001000001
10C000000000000000000001
100000000000100000000001
111111111111111111111111
