NO assets/blocks/pink_wall.xpm
EA assets/blocks/pink_wall.xpm
SO assets/blocks/pink_wall.xpm
WE assets/blocks/pink_wall.xpm

F 15C,100,0
C 71,171,169

1111111111111111111111111111111111111111111111111111111111111111111111
1000000000000000000000010000000000000000000000100000000000000000000001
1000000000000000000000010000000000000000000000100000000000000000000001
1000000001111111110000010000000011111111100000100000000111110001000001
1111111111111111111111111111111110000000111111111111111111111111111111
1000000000000000000000010000000000000000000000100000000000000000000001
100000000000C0000000000100000000000C0000000000100000000000C00000000001
1000000000000000C1000001000000000000000C1000001000000000000000C1000001
110000C0000000000000001110000C0000010000000001110000C00000100000000011
1000000000000000000000010000000000000000000000100000000000000000000001
1000000000000000010000011111111111111111100000100000000000000001000001
1000000000000000010000010000000000000000100000100000000000000001000001
1000000000000000010000010000000000000000100000100000000000000001000001
10C0000000000000000000010C0000000000S00000000010C000000000000000000001
1000000000001000000000010000000000010000000000100000000000100000000001
1111111111000000111111111111111100000000011111111111111111100011111111
1000000000000000000000010000000000000000000000100000000000000000000001
1000000000000000000000010000000000000000000000100000000000000000000001
1000000001111111110000010000000011111111100000100000000CCCCCCCC1000001
1111111111110000001111111111011111111111111111111111111111111111111111
1000000000000000000000010000000000000000000000100000000000000000000001
100000000000C0000000000100000000000C0000000000100000000000C00000000001
1000000000000000C1000001000000000000000C1000001000000000000000C1000001
110000C0000010000000001110000C0000010000000001110000C00000100000000011
1000000000000000000000010000000000000000000000100000000000000000000001
1000000000000000010000010000000000000000100000100000000000000001000001
1000000000000000010000010000000000000000100000100000000000000001000001
1000000000000000010000010000000000000000100000100000000000000001000001
10C0000000000000000000010C0000000000000000000010C000000000000000000001
1000000000001000000000010000000000010000000000100000000000100000000001
1111111111111111111111111111111111111111111111111111111111111111111111