NO ./assets/north_wall.xpm
    EA ./assets/east_wall.xpm
 SO ./assets/south_wall.xpm
WE ./assets/west_wall.xpm

F 153,   100,0
C 71,171,169

        1111111111111111110111111
        1000000000110000000000001
        1011000001110000000000001
        1001000000000000000000001
111110111011000001110000000000001
100000000011000001110111111111111
11110111111111011100000010001
11111111111111111101010010001
11000000110101011100000010000
10000000000000001100000010001
10000S00000000001101010010001
1100000111010101111101111000111
11110111 1110101 101111010001
11111111 1111111 111111111111