NO assets/north_wall.xpm
EA assets/east_wall.xpm
SO assets/south_wall.xpm
WE assets/west_wall.xpm

F 150,100,0
C 71,171,169

111111111111111111111111
100000000000000000000001
100000000000000000000001
100000000000000001000001
111111111111111111111111
100000000000000000000001
100000000000000000000001
100000000000000001000001
110000000000N00000000011
100000000000000000000001
100000000000000001000001
100000000000000001000001
100000000000000001000001
100000000000000000000001
100000000000100000000001
111111111111111111111111
