NO assets/blocks/pink_wall.xpm
EA assets/blocks/pink_wall.xpm
SO assets/blocks/pink_wall.xpm
WE assets/blocks/pink_wall.xpm

F 15C,100,0
C 71,171,169

111111111111111111111111
100000000000000000000001
100000000000000000000001
100000000CCCCCCCC1000001
111111111111111111111111
100000000000000000000001
100000000000C00000000001
1000000000000000C1000001
110000C00000N00000000011
100000000000000000000001
100000000000000001000001
100000000000000001000001
100000000000000001000001
10C000000000000000000001
100000000000100000000001
111111111111111111111111
