NO assets/north_wall.xpm
EA assets/east_wall.xpm
SO assets/south_wall.xpm
WE assets/west_wall.xpm

F 15C,100,0
C 71,171,169

1111111111111111111111111111111111111111111111111111111111111111111111111111111111111111111111111111
1111111111111111111111111111111111111111110111111111111111111111111111111111111111111111111111111111
1111111111111011101111111111111111111111111110111111011111101111111111111111111101111111111111111111
1111111111111111111111111111111111111111111111111111111111111111111111011111111111111111111111011111
1111111111111111111111111111111111111111111111111111101111111111110111111111010111111111110111111111
1111111111111110111111111111111111111111111111111111111111101111111111111111111111111111011111111111
1111111111111111111111111011111111111111111111111111111111111111111111111111111111111111111111111111
1111011111111111111111111111111111111111111111111111111111111111111111111111110111111111111111111111
1110111110111111111111111111111111111111111111111111111101111111111111111111111111110111111111111111
1111111111111111111111011111111111111111111111111111110111111110111111111111100111111111101000000001
111111111111111111111110C111111101111111101111111011111111111101111111111111101111111111100000000101
111111111111111111111000000000011111111111111111111111111111111111111100C000000000111101100000000001
1111111111111111111111000010000111111111011111111111111111111111111111001000000000111111100000000001
1111111111111111111110000000000111111111111111111111111111110111111111000000010001111111100000000001
1111111011111111110110010010000111111110111111111111111111010111111111001000000000111111110010000001
111111011111100000000000000100011011111111101111111111111111110111111100010000000011101110000000001
1111111111111000000000000000000111111111111111111111111111101111111111000000110000111111100000100001
1111111111011000000000000001000110111111111111111111111111111111111111000000000000111111000000000001
1101111111111000000000000100000101111111111111111111111111111111111111000000000000111110010000000001
11110111011110010000000000000010111111111111111111111101111111111111111000000000000010010000000000001
111111111111100000000000000000000000000110000000000000100000000000000010000000000000000000011000C01
11111111111110000000000000000000000000001100000001000011111111111111101111111110000000000000000001001
1111111111111000000000010000000000000011000000000000011111111110111111111111110000010000000000000001
11111111101110000000001111000000000000110000000000000111101111111111111111111100000000000000000001111
111111111011100000110C111100000000000011000000000000011111111111111111011111110000010010000000001011
11111111111110000000001111000000000C0011001000001000011111111111111111111101110000000000000000001111
1111111111111000000000111111111111111111000000000100011111111111111111111111110000000000000000000011
1110011111111000000000011111110111101111100001000000001111111111101111011111111000000000000000000111
1111111111111010000001111111111111111111111111111111100000000000000000001111111110000001000010100001111
1111111111111111111111111111111111111111111111111111111111111111110111000001000000000000011111111111
1110111111110111111111111111111111111111101111111111111110111111111111001111110000001000011111111101
1111111101111111111111111111111111111111111111111111111111111011111111001111110111111111C11111111111
1111111111110111111111111011001111111111111011101111101111111111111111001111111111111111111111111111
1111111111111111111110011111111110111111111111111101111111111111111111001111111111111111111111111111
1111111111111111111111111111111111111111111111111111111111111111111111001111111111111111101111111111
1111111111111111111111111111111111111111111111111111111111111111111111001111111101111111111111111101
1110111111111111101111111110111111111111111111111111111111011111111111101011111111111111111111111111
1111111111111111110101111101101111111111111111111011111111111110000000001111111111111111111111110111
1111111111111111110111111111111111111111111111111111010110111110000000001111111111111111111111011111
111011111111111111111011111111111111111111111111111011111111111C000000001111110110111111111111111111
1111111111111111111111111111111111111111110111111111111111111010000000001111111100000000000000111111
1111111111111111111011111111001111111111111101111111111111111110000000001111111100000000000000111111
11110111110111111111011111111111111111111111101111111111111101100000000011111111000000000000001111111
1111111111111111111111111111011111110111011111111111111111111110000000001111111100000000000000111111
111111111111111111111111111110000000000000C11111111111111000011000N00100111111110000000000000C11101111
1011111111111111110000001111110000000000000111100000111000111110000000001111111100000001001000111111
111111011111000000000000111100000100000000111000010000001111110000000001111111100000000000000011111111
1111111111111000000000000101000000000000000110000000000011111100000000100000000100000001001011111111
1111111111011000000000000111100010000000000110000000000011111100000000011111111000000000010001111111
1111111111111000001000100111100000000000000110000000000001111110001000001111111100000000000000110001
10111111111110000000000001001000100000000001100000000000001111100000000011111111111111100000011111111111
1111111111111000000000000111100000000100000110000001000001111110001000101011111101111100000000111111
1111111111101010000000000111100001000100000110100000000001111111111110111111111111111100000001111111
11111111111110010000000010111100010000000000000000000010011111111111101111111111111111100000111101111
11111111111010000000000001111C0000100000000100000000000011111011111110111111111111111111000000011111
1111111111111C0000000000011111111111111111111000010000000111111111111011111111111111110000000010111111
1111100111111010000010000111111111111111111110000000100001111111111100110111111111111100000001101111111
1011101111111111011110111111011111111111111111000001100001111111100000000000000000001110000000101011
11111111111111111111101011110111111111111111110C0000000001101011100000000000000000010100000000111111
1011111111111111101110111111111111111111111111110000000000111111110000000000000000001111101111111111
1111111111111111111110101111111111101111111011100000000100000111111111111111111111111111111111111111
11111111111101111111101101111101111111111111111001000C0100000111111111111111111111110111111111111111
1111111111111111111110110111111111111111111111100000010000000111111111011111111111111111111111111111
1111101111111111111110111011111111111110111111100000000001000011111111111111111110111111111111111111
1111111111111111111110111110111101111111111111100000000000000011011111111011111111111101111111111111
1111111111111111111110111111111111111111111111111111000100000111111111111110111111111111111111011111
1101111111111111111110111111111111111111111111111111111111111111111111111111111111111111111111110111
1111111111111111111110111111110111100111011111111111111111110111111111111101111111111111111101011111
