NO ./assets/north_wall.xpm
SO ./assets/south_wall.xpm
WE ./assets/west_wall.xpm
EA ./assets/east_wall.xpm

F 220,100,0
C 225,30,0

    1111111111111111111111111
1000000000110000000000001
1011000001110000000000001
1001000000000000000000001
1111111110110000011100001
100000000011000		00111N0001
1000000000110000001000001
1000000000000000001000001
1100000111010000001000001
1000000000110000001000001
1111111111110000001000001
1111111111111111111111111
