NO ./assets/north_wall.xpm
    EA ./assets/east_wall.xpm
 SO ./assets/south_wall.xpm
WE ./assets/west_wall.xpm

F 153,   100,0
C 71,171,169

000000001111111111111111111111111
000000001000000000110000000000001
0000P0001011000001110000000000001
000000001001000000000000000000001
111111111011000001110000000000001
1000000000110000011101P1111111111
11111111111111011100000010001
11110111111111011101010010001
1100000011010101110000000000P
10000p0000N000001100000000001
10000000000000001101010010001
1100000111010101111101111000111
11110111 1110101 101111010001
11111111 1111111 111111111111