NO assets/north_wall.xpm
EA assets/east_wall.xpm
SO assets/south_wall.xpm
WE assets/west_wall.xpm

F 15,100,0
C 71,171,169

TIMER 20

111111111111111111111111
100000000000000000000001
100000000000000000000001
100000000010000000000001
111111111111111111111111
100000000000000000000001
100000000000000000000001
100000000000000001000001
11000000000N000000000111
100000000000000000000001
100000000000000001000001
100000000000000001000001
10000000000000001000001
100000000000000000000001
100000000000100000000001
111111111111111111111111
