NO assets/north_wall.xpm
EA assets/east_wall.xpm
SO assets/south_wall.xpm
WE assets/west_wall.xpm

F 15,100,0
C 71,171,169


111111111111111111111111
100000000000000000000001
100000000000000000000001
100000000CCCCCCCC1000001
111111111111111111111111
100000000000000000000001
100000000000000000000001
1000000000000000C1000001
11000000000N00000000011
1C0000000000000000000001
100000000000000001000001
100000000000000001000001
10000C00000000001000001
10C000000000000000000001
100000000000100000000001
111111111111111111111111
